_____T___T___T___
|   | | |   |   |
|T__| | |L__|L__|
  | |_|_| | |   |
_L|_|   | | |M__|
| | |L__|M|_| |  
| | |   |   |B|__
|M|_|M__|___| | |
|   |   |   | | |
|B__|B__|B__|_|_|