_________________
|   | | |   |   |
|___| | |___|___|
  | |_|_| | |   |
__|_|   | | |___|
| | |___|_|_| |  
| | |   |   |_|__
|_|_|___|___| | |
|   |   |   | | |
|___|___|___|_|_|